11111111111111111111111111111111111111111111111111111111
100000100000100000C0010000000000111C01000000000000000001
11000011100010001000000000111111111001000000000000000001
10000C00000C00000000000000111111110011000000000000000001
100000000111111110000C0000011111100001000000000000000001
1000C0000110000010000000000000001000C1000011111111100001
10000000C0000000100000000000111110000100000000000C100001
10000000000000001111000000000000000001111111111111111001
10P0C00000000011111100000000100C000000000000000000000001
11111110111111111111000000000100000100000000000000000001
10000000000000000000000000000100000000000000000000000001
1000000000000000C000100000000100000000000000000000000001
10000000000000000000111111111100000000000000000000000001
100000000000000000001E0000000100000000C00000000000000001
100000000000000000001000C0000100000000000000000000000001
10000000000000000000111111100100000000000000000C00000001
10000000000000000000100000000100000000000000000000000001
1000000000000000000010000000010000000C000000000000000001
10000000000C00000000100000000111111111111111111111110001
10000000000000000000100000000000000000000000000000000001
11111111111111111111111111111111111111111111111111111111