111111111111111111111111111111111111111111111111
1P00000000000000000000000000000000C0000000000001
111111111111111110011111111111111111111111111101
111111111111111100000000000000000000011111111101
111111111111111001111111111111111111000000111101
11000C00000000000000000000000000001100C011111101
110111111111111111111111111111101011111111111101
11011111111111111111111111111000000000000C111101
11010000000000000000C000000000111011111011111101
110111111110111111111111111110111011111011111101
1101111000000000001111111111101110111110C0000101
110111101111111110111111111110111011111111111101
110111100000011110111100000010011111111111111101
11011110000C0111101111011111110000000000C0000101
110111101111111110111101111100011111111111110101
110100000011111110111101111101111111111111110001
1001111110000000000C0000000000001000000000000101
101111110000011111111111111111111000111111111101
101111111111001111111111100000000010000000000101
1C1111111111101111111111101111111111111111110001
101C00000000000000000000C00000000000000000000101
1E1111111111111111111111111111111111111111111101
111111111111111111111111111111111111111111111111